222220000022222
233020000023332
234020000023302
203020000023302
222220000022222
000000000000000
000000040000000
222220000022222
203320000023332
203320000023332
233320000023332
222220000022222